77777777777777777777
44444444444444444444
44444444444444444444
44444444444444444444
44444444444444444444
44444444444444444444
44444444444444444444
11111114444441111111