77777774444447777777
44444444444444444444
44444444444444444444
44444444444444444444
44444441111114444444
44444444444444444444
44444444444444444444
11111114444441111111